006000000000000
010101010101010
002000000220060
022206000220000
002000022222200
060022022222200
000022000220000
002222220220033
002222226000000
000022000020000
200022060222002
320000000020023
332600010000233
333200222002333
333320242023333