066016606616000
000212000212600
000222030222000
000212000212000
100111010111221
000010000010000
222210000010000
000012222210000
600000000000000
000010232010000
006610222012222
006610000010000
112111111111011
060000222000060
006000242066006