000000000000000
020200202020020
020226202022020
020020212006020
000220202002000
020255202002020
020000000000020
102220232022201
000000202000000
002020202002020
002020202002020
002020262002020
002020000002020
002020222002000
000000242000020