000100000001000
000122222221000
101122333221101
000000333000000
000000000002003
003300020023000
033000210033000
000020000000000
000200330002323
022330022000000
020000020233010
200020020020020
002000000002020
020030222030200
201030242030000