020202600202620
202623252020252
625202020262320
202026212020202
026252020202620
202320202620202
020202020252020
262026202326202
025202020202020
202020212020262
026202020202520
202020202026202
020232020232020
202620222026202
026250242002020