066666606666660
020002212200222
020000111200222
020000012200222
020006660066000
020006660066000
020000033322333
020000333322333
020003360060002
020003620000000
000003001100110
020033000000000
000336000100120
023326222000220
023320242000220