033333303333330
000000000000000
002222222222222
002222222222222
002200000200000
002200220200000
002200220202230
002200220202200
000000220202203
000000220002200
002222222222230
002222222222200
002210000000003
002210222030000
002210242030030