555555555555555
555555555555555
111111222111111
555525555525555
555525555525555
221111111111122
555555555555555
555555555555555
111111222111111
555555555555555
555555555555555
221111111111122
060000060000000
000060222006006
006000242000600