000010000000000
110110121011011
000000121000000
201000100000020
221133111033321
020000000000000
021002222230000
021222000222300
101000000002222
000220000000000
011221111101221
000000000001000
000100030020200
000000222001000
000100242002000