555125555201555
202555555555555
000602555522222
620006600662222
006201006100222
200606060000022
001060600000102
222222111333332
122220032000002
002200032333333
001100032000000
000000013333330
300000000000600
330000222060000
333100242006006