055555606555550
000000616000000
200000222000002
220000222000022
022000020000220
622200222002220
002202222202206
062220222022200
000200222002600
033300020003330
000000202000000
000022000220000
000033000330000
000000222000000
010000242000010