555555555555555
222222222222222
222222222222222
222222222222222
330333033303033
010101010101010
000000000000000
121212121212121
200000060000062
262222222222202
202000000600202
202022222220262
202620000020202
202020222026202
262020242020202